!!!!!!!!!!!!!!!!!!!!!!
!####################!
!####..E....P....E..#!
!####.#.#####.###.#.#!
!#.E.E#...####..#..##!
!#.##########.#.##.##!
!###.##...#...#######!
!###.#..#.#.##F..####!
!#.#...##.#....#...##!
!#.##..#..#.##.###.##!
!#.######.##..####.##!
!#FFF...#.#.##.F....#!
!######.##....#####.#!
!#...##.#.#.##.####F#!
!###..E...#........I#!
!####################!
!!!!!!!!!!!!!!!!!!!!!!